oooooooooooooooooo
o........oo......o
o........Xo......o
o........Xo......o
o......oooo......o
o................o
o................o
oo...............o
o................o
o................o
o.......o........o
o................o
o...............oo
o................o
o................o
o................o
o..............o.o
o................o
o................o
o................o
o..............ooo
o.....o.........oo
o................o
oo...............o
o................o
o................o
o.....o..........o
o................o
o..............o.o
o................o
o................o
o................o
o...............oo
o................o
o................o
o.....ooo........o
o................o
o................o
o..............ooo
ooo..............o
o................o
o................o
o................o
o...oo...........o
o................o
o........o.......o
o................o
o...............oo
o................o
o................o
o................o
o............oo..o
o...oo...........o
o................o
o................o
o................o
o.......oo.......o
o................o
o................o
ooo..............o
o................o
o................o
o.......oo.......o
o................o
oo...............o
o...............oo
o................o
o................o
o................o
o.............oo.o
o....oo..........o
o................o
o................o
o................o
oooo.....o.......o
o................o
o................o
o................o
o............oo..o
o................o
o................o
o.....o..........o
o................o
o................o
o............ooooo
o................o
o................o
o................o
oooooooooooooooooo
TTTTTTTTTTTTTTTTTT
