...................#
...................#
...................#
...................#
...................#
...................#
...................#
...................#
...................%
...................%
...................%
...................#
.....#......%......#
............%......#
####################