######.............#......
#..................#......
#..................#......
#...............####......
#..................#......
#..................#......
#.........###......#......
#..................#......
#..................%......
#..................%......
#.....##...........%......
...................%......
...........#.......#......
..........#........#......
######..##################
