...................#
...................#
...................#
...................#
...................#
...................#
...................#
...................#
...................#
...........##......%
####....###........%
####......#........%
####......#........#
####......#........#
####################
