....................
....................
....................
....................
....................
....................
....................
....................
....................
....................
....................
....................
.....#..............
....................
####################
