################################################
#..............................................#
#..............................................#
#..............................................#
#..............................................#
#..............................................#
#..............................................#
#..............................................#
#..............................................#
#..............................................#
#..............................................#
#..............................................#
#..............................................#
#..............................................#
#..............................................#
#..............................................#
#..............................................#
#..............................................#
#..............................................#
#..............................................#
#..............................................#
#..............................................#
#..............................................#
#..............................................#
################################################
#..............................................#
#..............................................#
#..............................................#
#..............................................#
#..............................................#
#..............................................#
#..............................................#
#..............................................#
######.........................................#
#.........##...................................#
#..............................................#
#...............####...........................#
#..............................................#
#..............................................#
#.........###..................................#
#..................#...........................#
#..................%...........................#
#..................%...........................#
#.....##...........%...........................#
#..................%...........................#
#..........#.......#.........................###
#.........#........#.........................###
################################################
