....................
....................
....................
....................
....................
....................
....................
....................
....................
...........##.......
####....###.........
####......#.........
####......#.........
####......#.........
####################
